11111111111111111111
1P0C0C0C0C0C0C0C0C01
11111111111111111011
10C0C0C0C0C0C0C0C0C1
10111111111111111111
1C0C0C0C0C0C0C0C0C01
11111111111111111011
100C00C00C00C00C00C1
10111111111111111111
10C0C0C0C0C0C0C0C0C1
11111111111111111011
1C000C000C000C000C01
10111111111111111111
10C0C0C0C0C0C0C0C0C1
11111111111111111011
1C00C00C00C00C00C001
10111111111111111111
10C0C0C0C0C0C0C0C0E1
11111111111111111011
11111111111111111111
