1111111
1P00E01
1111101
1C11101
1111101
1000001
1111111
