1111111111
1P000000E1
1011111101
1C00000001
1010111101
1C00001001
1000000001
1111111111
