11111111111111111111
1P0000000000000000E1
1C0C0C0C0C0C0C0C0C01
10C0C0C0C0C0C0C0C0C1
1C0C0C0C0C0C0C0C0C01
10C0C0C0C0C0C0C0C0C1
1C0C0C0C0C0C0C0C0C01
10C0C0C0C0C0C0C0C0C1
1C0C0C0C0C0C0C0C0C01
10C0C0C0C0C0C0C0C0C1
1C0C0C0C0C0C0C0C0C01
10C0C0C0C0C0C0C0C0C1
1C0C0C0C0C0C0C0C0C01
10C0C0C0C0C0C0C0C0C1
1C0C0C0C0C0C0C0C0C01
10C0C0C0C0C0C0C0C0C1
1C0C0C0C0C0C0C0C0C01
10C0C0C0C0C0C0C0C0C1
1C0C0C0C0C0C0C0C0C01
11111111111111111111
