111111
1CCC01
1C1C01
1E1P01
111111